,Ward Precinct ,THOMAS M MENINO,MICHAEL F FLAHERTY,WILLIAM FEEGBEH (WRITE-IN),ALL OTHERS,VOTES CAST,BLANKS,BALLOTS CAST,Registered Voters,CVAP,TOTAL POP.,WHITE,AFRICAN_AMERICAN,NATIVE_AMERICAN,ASIAN,OTHER
0,101,200,193,0,0,393,4,397,1113,534.0,960.039644976074,0.567,0.033,0.0,0.1,0.146
1,102,166,105,0,2,273,0,273,816,814.0,2041.5446542793864,0.667,0.023,0.001,0.057,0.026
2,103,365,229,0,0,594,6,600,1720,1422.0,3134.4631436803493,0.65,0.062,0.003,0.051,0.048
3,104,115,66,0,0,181,2,183,563,537.0,1721.8679524360412,0.567,0.073,0.003,0.032,0.062
4,105,164,121,0,0,285,1,286,960,980.0,3189.9805348669306,0.645,0.032,0.008,0.001,0.099
5,106,146,107,0,0,253,1,254,836,1030.0,3160.0554369112288,0.609,0.047,0.002,0.013,0.141
6,107,129,129,0,1,259,1,260,1046,1111.0,3088.948397214824,0.59,0.045,0.001,0.043,0.129
7,108,210,162,0,3,375,6,381,1413,1120.0,2730.354434335149,0.569,0.026,0.003,0.091,0.072
8,109,126,87,0,1,214,1,215,838,568.0,1603.071533523147,0.527,0.024,0.005,0.037,0.104
9,110,81,74,0,0,155,2,157,582,766.0,2295.9773133768063,0.581,0.033,0.004,0.02,0.125
10,111,348,172,0,1,521,5,526,1296,1169.0,1647.7817463671431,0.804,0.018,0.0,0.035,0.058
11,112,355,174,0,0,529,3,532,1315,1104.0,2417.360508561329,0.711,0.059,0.0,0.02,0.045
12,113,382,194,0,3,579,4,583,1627,1372.0,2525.706053583249,0.745,0.046,0.0,0.025,0.049
13,114,196,114,0,2,312,6,318,943,683.0,1426.1957943968305,0.71,0.055,0.0,0.021,0.059
14,115,1,0,0,0,1,0,1,223,94.0,99.46542354779484,0.424,0.352,0.0,0.0,0.092
15,201,309,399,0,0,708,4,712,1948,2748.0,3405.3202712347547,0.911,0.021,0.0,0.028,0.015
16,202,304,340,0,1,645,1,646,2339,2030.0,3137.7887391885897,0.615,0.179,0.0,0.154,0.016
17,203,225,311,0,2,538,2,540,1579,1063.0,1351.811697568332,0.872,0.063,0.0,0.027,0.008
18,204,192,198,0,1,391,5,396,1398,1261.0,1683.063519978428,0.794,0.107,0.0,0.046,0.015
19,205,227,327,0,3,557,1,558,1628,1125.0,1441.8616468427847,0.816,0.093,0.0,0.044,0.017
20,206,357,382,0,3,742,5,747,1903,1010.0,1295.3752894450354,0.838,0.069,0.0,0.042,0.02
21,207,186,286,0,1,473,2,475,1286,1333.0,1567.6323618295917,0.946,0.018,0.0,0.025,0.011
22,301,616,490,0,2,1108,5,1113,3487,1386.0,1603.1518694461129,0.901,0.032,0.001,0.034,0.013
23,302,194,201,0,0,395,3,398,1546,1762.0,1976.0047923933184,0.942,0.036,0.0,0.014,0.004
24,303,206,189,0,0,395,5,400,1528,2429.0,2708.792528016364,0.94,0.018,0.0,0.032,0.002
25,304,293,221,0,1,515,3,518,1616,1655.0,1830.0522183528108,0.892,0.034,0.001,0.055,0.009
26,305,360,380,0,5,745,7,752,2646,3116.0,4059.308949333325,0.708,0.078,0.003,0.184,0.013
27,306,402,344,0,2,748,7,755,3479,5412.0,6607.760651355292,0.766,0.053,0.006,0.137,0.02
28,307,502,475,0,7,984,2,986,3726,3032.0,4242.518378155484,0.551,0.098,0.0,0.217,0.127
29,308,622,300,0,2,924,17,941,3805,4970.0,7303.78795980819,0.411,0.046,0.006,0.485,0.03
30,401,308,281,0,0,589,4,593,1966,1540.0,1981.795085309681,0.734,0.073,0.002,0.09,0.083
31,402,339,298,0,2,639,4,643,2655,3750.0,4459.387551520278,0.727,0.155,0.005,0.056,0.053
32,403,185,153,0,0,338,2,340,1310,1164.0,1484.456752169635,0.637,0.193,0.007,0.069,0.079
33,404,294,260,0,1,555,5,560,1943,1713.0,2147.97130626097,0.661,0.177,0.003,0.093,0.06
34,405,158,161,0,2,321,2,323,1550,2283.0,2708.6289604079057,0.71,0.117,0.005,0.137,0.012
35,406,173,128,0,2,303,2,305,1354,2094.0,2832.5801335733213,0.628,0.127,0.002,0.203,0.02
36,407,141,115,0,3,259,3,262,1701,2401.0,3002.4489151043986,0.69,0.09,0.0,0.17,0.03
37,408,131,103,0,0,234,0,234,1578,6264.0,7210.271854943775,0.758,0.063,0.0,0.13,0.029
38,409,79,30,0,1,110,2,112,1048,3683.0,4436.316753014857,0.604,0.16,0.003,0.12,0.081
39,410,16,25,0,0,41,1,42,945,5228.0,6260.470625228448,0.648,0.1,0.001,0.146,0.071
40,501,619,424,0,3,1046,11,1057,3990,4768.0,6028.519632019613,0.63,0.032,0.001,0.302,0.017
41,502,181,191,0,2,374,3,377,2449,3777.0,4892.267613681287,1.5470000000000002,0.07500000000000001,0.003,0.28,0.076
42,503,221,233,0,1,455,4,459,1702,2119.0,2561.156172177334,0.93,0.015,0.002,0.038,0.009
43,504,181,212,0,1,394,4,398,2135,1837.0,2222.614198277982,0.893,0.022,0.01,0.062,0.006
44,505,87,130,0,2,219,2,221,655,821.0,1020.3147680399968,0.946,0.012,0.003,0.027,0.011
45,506,191,226,0,0,417,3,420,1843,2081.0,2449.31970592007,0.894,0.006,0.001,0.073,0.013
46,507,221,296,0,0,517,3,520,2133,2065.0,2429.821576362041,0.892,0.006,0.001,0.076,0.013
47,508,223,249,0,0,472,6,478,2026,2199.0,2705.614029056017,0.871,0.016,0.002,0.08,0.015
48,509,207,260,0,2,469,1,470,2893,3501.0,4194.880541405345,0.84,0.018,0.001,0.113,0.01
49,510,156,129,0,1,286,0,286,2380,4924.0,5902.084359980943,0.744,0.029,0.001,0.189,0.019
50,511,185,194,0,3,382,0,382,1173,1674.0,2049.6251269208224,0.916,0.018,0.007,0.047,0.008
51,601,222,457,0,1,680,3,683,2533,3073.0,3984.837951821689,0.733,0.115,0.004,0.051,0.084
52,602,123,258,0,0,381,6,387,1171,1424.0,2147.96443624557,0.575,0.188,0.007,0.057,0.16
53,603,118,344,0,2,464,7,471,1430,1021.0,1204.5210063395582,0.925,0.001,0.001,0.052,0.0
54,604,165,372,0,2,539,2,541,1552,1603.0,1796.288081185333,0.935,0.01,0.0,0.041,0.008
55,605,137,397,0,5,539,5,544,1413,1571.0,1746.3181933167652,0.924,0.012,0.0,0.049,0.013
56,606,205,434,0,0,639,5,644,1362,1352.0,1480.5300952896089,0.971,0.005,0.0,0.013,0.011
57,607,158,420,0,2,580,7,587,1389,1738.0,1940.600394655232,0.94,0.009,0.001,0.038,0.009
58,608,153,488,0,3,644,6,650,1422,1199.0,1445.9572144480182,0.984,0.001,0.001,0.011,0.0
59,609,171,493,0,1,665,3,668,1374,1626.0,1832.43315852836,0.995,0.0,0.004,0.0,0.0
60,701,184,422,0,1,607,3,610,1262,1592.0,1893.4075276315457,0.98,0.002,0.001,0.012,0.002
61,702,201,489,0,3,693,2,695,1563,1454.0,1604.6316550943902,0.978,0.007,0.0,0.009,0.004
62,703,273,597,0,4,874,7,881,1871,2190.0,2425.838541735236,0.981,0.007,0.0,0.007,0.001
63,704,168,377,0,4,549,3,552,1598,1458.0,2029.481069147719,0.76,0.051,0.0,0.061,0.112
64,705,130,270,0,3,403,0,403,1238,2093.0,2757.880306776554,0.805,0.039,0.001,0.065,0.073
65,706,161,258,0,1,420,1,421,1296,946.0,1478.4146423732352,0.654,0.079,0.0,0.087,0.163
66,707,154,130,0,0,284,4,288,943,1246.0,2376.025412437458,0.349,0.276,0.002,0.208,0.15
67,708,111,201,0,2,314,3,317,926,1685.0,2526.9018073202774,0.58,0.112,0.0,0.198,0.096
68,709,168,163,0,0,331,2,333,1005,927.0,1367.2041397100572,0.576,0.117,0.0,0.175,0.112
69,710,246,81,0,0,327,3,330,1236,1169.0,2061.212957605532,0.229,0.32,0.007,0.071,0.334
70,801,156,64,0,1,221,1,222,911,1707.0,2591.856583822389,0.48,0.169,0.0,0.183,0.147
71,802,252,200,0,1,453,3,456,2045,3187.0,4495.220130484659,0.439,0.228,0.003,0.155,0.152
72,803,185,77,0,1,263,1,264,1131,1558.0,2285.696069134881,0.178,0.563,0.009,0.05,0.155
73,804,105,42,0,0,147,3,150,604,691.0,1114.2205908879444,0.128,0.583,0.011,0.042,0.176
74,805,255,87,0,1,343,4,347,1239,847.0,1470.1008139009991,0.107,0.547,0.005,0.034,0.265
75,806,100,29,0,0,129,5,134,446,1362.0,1955.6053701865883,0.173,0.577,0.01,0.04,0.162
76,807,171,81,0,0,252,3,255,901,554.0,809.9269487643014,0.146,0.62,0.006,0.025,0.163
77,901,284,181,0,2,467,6,473,1854,2178.0,2921.3259123631765,0.59,0.065,0.0,0.235,0.107
78,902,244,224,0,2,470,0,470,1937,2210.0,2829.733297344713,0.619,0.16,0.001,0.091,0.094
79,903,426,212,0,1,639,9,648,2777,2938.0,4513.065234171289,0.389,0.382,0.002,0.049,0.146
80,904,289,93,0,2,384,6,390,1868,1935.0,3137.85743598095,0.312,0.42,0.005,0.081,0.143
81,905,394,195,0,0,589,6,595,1823,2288.0,3321.505907121013,0.351,0.468,0.001,0.084,0.061
82,1001,139,88,0,0,227,0,227,845,650.0,877.7258229410415,0.416,0.279,0.007,0.107,0.143
83,1002,141,102,0,0,243,5,248,1098,1422.0,1919.597025891428,0.553,0.195,0.003,0.132,0.081
84,1003,111,106,0,1,218,3,221,1063,1629.0,2185.7516875532674,0.626,0.132,0.0,0.164,0.05
85,1004,350,135,0,1,486,7,493,1655,1241.0,1639.1742349664112,0.469,0.181,0.0,0.186,0.125
86,1005,139,156,0,0,295,9,304,1188,2323.0,2988.9434666708025,0.547,0.225,0.002,0.124,0.071
87,1006,161,100,0,3,264,3,267,1157,1500.0,2509.591515657937,0.337,0.428,0.003,0.044,0.156
88,1007,297,95,0,1,393,0,393,1610,1281.0,2239.7578255456115,0.423,0.317,0.001,0.025,0.188
89,1008,222,170,0,1,393,5,398,1660,2365.0,3005.8601430634108,0.638,0.16,0.009,0.095,0.073
90,1009,258,260,0,1,519,2,521,1807,1676.0,2340.1397333265586,0.643,0.148,0.01,0.055,0.112
91,1101,154,114,0,6,274,4,278,831,1277.0,1873.3910771596632,0.223,0.548,0.0,0.04,0.154
92,1102,272,128,0,3,403,2,405,1308,1272.0,2148.177706427165,0.143,0.587,0.001,0.033,0.186
93,1103,206,82,0,0,288,4,292,1081,878.0,1428.8889291430817,0.154,0.629,0.0,0.027,0.129
94,1104,295,150,0,3,448,6,454,1616,1867.0,3190.011335266928,0.266,0.397,0.0,0.043,0.257
95,1105,291,142,0,2,435,8,443,1485,1133.0,1813.4899155065364,0.348,0.35,0.0,0.046,0.214
96,1106,167,207,0,1,375,5,380,1103,1288.0,1810.076806912388,0.527,0.247,0.0,0.054,0.117
97,1107,235,252,0,8,495,7,502,1562,1653.0,2259.233375992058,0.607,0.208,0.003,0.042,0.107
98,1108,225,263,0,2,490,6,496,1501,1992.0,2925.104437831213,0.554,0.187,0.021,0.06,0.154
99,1109,164,227,0,1,392,1,393,978,796.0,1039.3434571785865,0.703,0.095,0.003,0.075,0.088
100,1110,189,219,0,2,410,6,416,1412,881.0,1192.0414679048963,0.66,0.132,0.004,0.066,0.107
101,1201,330,148,0,3,481,5,486,1485,1585.0,2559.8980765757915,0.074,0.711,0.004,0.022,0.127
102,1202,403,203,0,0,606,4,610,2013,1841.0,2734.788770130675,0.075,0.78,0.001,0.001,0.133
103,1203,210,89,0,0,299,0,299,916,716.0,1178.0016669676793,0.051,0.711,0.005,0.043,0.119
104,1204,179,86,0,0,265,4,269,985,914.0,1642.2909540322592,0.088,0.705,0.008,0.0,0.138
105,1205,201,75,0,0,276,3,279,754,567.0,899.64895792117,0.056,0.739,0.004,0.033,0.112
106,1206,178,64,0,1,243,4,247,755,900.0,1378.35102640512,0.078,0.762,0.003,0.001,0.128
107,1207,447,140,0,1,588,12,600,2242,2504.0,4248.028876634819,0.121,0.683,0.003,0.002,0.159
108,1208,124,62,0,0,186,0,186,733,759.0,1071.294581289121,0.075,0.837,0.0,0.0,0.087
109,1209,206,86,0,1,293,3,296,867,1080.0,1745.1033507116629,0.079,0.756,0.002,0.001,0.149
110,1301,294,91,0,0,385,3,388,1263,1108.0,2115.150024459506,0.078,0.654,0.006,0.022,0.201
111,1302,85,28,0,0,113,1,114,539,487.0,929.7902539374916,0.084,0.648,0.0,0.025,0.202
112,1303,190,97,0,0,287,0,287,1580,1349.0,2643.1367463006727,0.382,0.238,0.003,0.239,0.103
113,1304,176,65,0,0,241,1,242,948,1032.0,1709.1594525837056,0.138,0.604,0.001,0.03,0.199
114,1305,163,82,0,1,246,4,250,808,967.0,1466.4342399692905,0.289,0.405,0.002,0.044,0.229
115,1306,250,134,0,1,385,14,399,1260,1142.0,1838.897972040546,0.333,0.298,0.001,0.052,0.272
116,1307,166,251,0,1,418,3,421,1199,776.0,1278.503088925712,0.573,0.078,0.0,0.23,0.094
117,1308,192,154,0,1,347,0,347,1164,1057.0,1836.7584302402204,0.561,0.069,0.0,0.244,0.094
118,1309,212,198,0,0,410,1,411,1198,1229.0,2129.102566747254,0.419,0.197,0.001,0.156,0.193
119,1310,338,408,0,1,747,8,755,1600,1524.0,2506.516579133716,0.524,0.13,0.001,0.244,0.078
120,1401,346,88,0,0,434,1,435,1980,2482.0,4346.062530311858,0.075,0.617,0.034,0.014,0.248
121,1402,447,125,0,1,573,4,577,2171,2324.0,4344.635769766972,0.085,0.702,0.008,0.012,0.168
122,1403,244,62,0,0,306,1,307,1166,1197.0,2210.205694982784,0.043,0.711,0.002,0.025,0.198
123,1404,277,91,0,0,368,7,375,1346,1353.0,2560.409444940285,0.063,0.701,0.003,0.008,0.189
124,1405,179,64,0,0,243,2,245,970,937.0,1676.5711056829912,0.06,0.878,0.001,0.0,0.033
125,1406,212,74,0,2,288,1,289,931,1053.0,1866.5851148960232,0.051,0.749,0.003,0.02,0.154
126,1407,219,73,0,0,292,3,295,1122,1117.0,2117.3947024521226,0.115,0.667,0.013,0.017,0.172
127,1408,260,74,0,0,334,2,336,953,889.0,1625.9931801600392,0.062,0.909,0.002,0.002,0.019
128,1409,196,42,0,0,238,2,240,1133,1045.0,2003.4912271264104,0.115,0.664,0.014,0.016,0.177
129,1410,259,74,0,2,335,1,336,1182,1278.0,2888.267753830341,0.106,0.636,0.014,0.002,0.232
130,1411,139,40,0,1,180,1,181,852,888.0,2023.5750278454111,0.105,0.644,0.013,0.002,0.226
131,1412,130,49,0,0,179,0,179,668,494.0,1006.4636012348102,0.094,0.695,0.011,0.002,0.187
132,1413,196,63,0,0,259,0,259,938,903.0,1462.7359250672885,0.065,0.85,0.003,0.0,0.068
133,1414,238,74,0,1,313,6,319,1058,1211.0,2240.8953352642056,0.06,0.905,0.001,0.0,0.024
134,1501,233,101,0,0,334,5,339,1331,1462.0,2627.6617918812185,0.121,0.515,0.011,0.03,0.294
135,1502,193,42,0,1,236,4,240,895,818.0,1501.3277706754398,0.097,0.548,0.014,0.005,0.301
136,1503,116,45,0,1,162,2,164,584,638.0,1205.8775894081143,0.126,0.513,0.01,0.12,0.202
137,1504,281,121,0,3,405,2,407,1678,1677.0,3271.6818981014508,0.149,0.411,0.002,0.124,0.291
138,1505,190,74,0,1,265,3,268,1107,1155.0,2138.224086529938,0.09,0.604,0.001,0.044,0.237
139,1506,133,110,0,3,246,4,250,736,834.0,1402.669714956194,0.331,0.263,0.0,0.288,0.098
140,1507,165,71,0,0,236,2,238,897,784.0,1527.3251986440778,0.099,0.438,0.0,0.055,0.384
141,1508,174,59,0,0,233,1,234,867,910.0,1602.683059742183,0.14,0.583,0.001,0.123,0.127
142,1509,174,113,0,0,287,1,288,948,1173.0,2294.996655369492,0.123,0.459,0.0,0.147,0.251
143,1601,172,149,0,1,322,3,325,1038,1005.0,1502.9531148263934,0.301,0.306,0.008,0.23,0.126
144,1602,141,141,0,0,282,1,283,732,2567.0,3920.861109383932,0.376,0.15,0.0,0.354,0.078
145,1603,227,196,0,2,425,12,437,1356,888.0,1474.5410635936084,0.16,0.625,0.009,0.083,0.085
146,1604,199,183,0,0,382,3,385,1229,871.0,1322.4167876515305,0.359,0.265,0.001,0.269,0.047
147,1605,244,242,0,2,488,2,490,1346,1161.0,1785.7143424537198,0.353,0.211,0.001,0.32,0.064
148,1606,277,217,0,3,497,2,499,1700,1212.0,1787.7270375681965,0.407,0.337,0.002,0.173,0.022
149,1607,289,309,0,2,600,3,603,1201,1539.0,2278.7849968405185,0.384,0.33,0.002,0.193,0.023
150,1608,284,302,0,0,586,1,587,1236,776.0,1096.490114820298,0.552,0.335,0.0,0.076,0.017
151,1609,311,452,0,1,764,17,781,1371,889.0,1150.673389633986,0.954,0.026,0.0,0.0,0.013
152,1610,224,269,0,0,493,3,496,1164,1086.0,1327.0289640326148,0.79,0.12,0.002,0.047,0.017
153,1611,347,290,0,4,641,5,646,1307,1826.0,2554.934458726706,0.59,0.306,0.0,0.069,0.016
154,1612,397,407,0,1,805,3,808,1271,1776.0,2298.9927946182943,0.955,0.026,0.0,0.0,0.013
155,1701,215,63,0,0,278,4,282,1116,1206.0,2038.9409218959172,0.053,0.758,0.008,0.016,0.141
156,1702,146,71,0,0,217,2,219,768,831.0,1508.7242054667988,0.093,0.685,0.002,0.062,0.137
157,1703,325,165,0,2,492,4,496,1578,1783.0,2747.6016410383977,0.102,0.697,0.013,0.03,0.144
158,1704,477,222,0,2,701,2,703,1781,1827.0,3010.9715273431234,0.185,0.7,0.0,0.087,0.009
159,1705,134,37,0,0,171,0,171,744,781.0,1305.3148079028126,0.092,0.728,0.009,0.054,0.084
160,1706,255,169,0,2,426,6,432,1227,966.0,1456.310407112622,0.221,0.531,0.013,0.074,0.138
161,1707,140,43,0,1,184,0,184,632,877.0,1391.0695609971308,0.065,0.86,0.0,0.0,0.045
162,1708,253,89,0,1,343,2,345,1071,1153.0,1993.5381943786688,0.136,0.682,0.006,0.085,0.053
163,1709,241,122,0,0,363,3,366,846,829.0,1430.5246672801509,0.138,0.685,0.006,0.084,0.051
164,1710,281,125,0,1,407,1,408,1459,1372.0,2202.78126125232,0.091,0.828,0.0,0.02,0.035
165,1711,88,58,0,0,146,3,149,519,454.0,754.4700565966112,0.161,0.742,0.0,0.075,0.011
166,1712,249,83,0,0,332,1,333,894,750.0,1202.4125927161383,0.165,0.714,0.0,0.065,0.021
167,1713,306,259,0,1,566,4,570,1373,1770.0,2558.69997619624,0.494,0.376,0.0,0.089,0.013
168,1714,224,132,0,5,361,1,362,978,1003.0,1596.5817507366023,0.28,0.532,0.0,0.135,0.0
169,1801,411,153,0,0,564,10,574,1899,2241.0,3655.58931343189,0.106,0.79,0.0,0.036,0.027
170,1802,320,107,0,1,428,4,432,1312,1444.0,2550.4783378929965,0.051,0.888,0.0,0.0,0.027
171,1803,401,115,0,0,516,3,519,1550,1848.0,3152.4054507000533,0.043,0.913,0.0,0.002,0.022
172,1804,374,104,0,0,478,1,479,1518,1652.0,2655.0820660207146,0.039,0.904,0.0,0.003,0.031
173,1805,428,133,0,0,561,4,565,1563,1197.0,1847.1652932372065,0.145,0.734,0.012,0.012,0.062
174,1806,455,143,0,0,598,3,601,1697,1353.0,2088.306621113258,0.145,0.734,0.012,0.012,0.062
175,1807,322,126,0,3,451,3,454,1300,1903.0,2792.8419433860304,0.459,0.307,0.01,0.021,0.122
176,1808,652,182,0,0,834,4,838,2398,2967.0,4524.107251323796,0.194,0.679,0.009,0.012,0.066
177,1809,357,225,0,2,584,6,590,1333,1676.0,2402.9610239105027,0.42,0.397,0.004,0.054,0.086
178,1810,487,263,0,1,751,9,760,1966,1883.0,2767.5135118721364,0.569,0.257,0.001,0.062,0.072
179,1811,260,107,1,0,368,3,371,1306,1230.0,2214.1951836186345,0.37,0.479,0.009,0.022,0.101
180,1812,430,165,0,1,596,6,602,1431,1531.0,2218.989256600543,0.352,0.405,0.0,0.017,0.147
181,1813,214,58,0,0,272,0,272,854,885.0,1333.7040191095389,0.25,0.614,0.0,0.018,0.071
182,1814,214,71,0,1,286,1,287,907,879.0,1341.861909857898,0.495,0.352,0.0,0.016,0.1
183,1815,332,113,0,1,446,4,450,1310,1449.0,2183.867478211093,0.251,0.615,0.0,0.018,0.068
184,1816,545,262,0,0,807,12,819,1525,2190.0,3123.3772339559814,0.48,0.407,0.0,0.007,0.025
185,1817,421,156,0,0,577,5,582,1367,1577.0,2227.399652826822,0.496,0.391,0.0,0.008,0.027
186,1818,505,183,0,1,689,4,693,1751,2077.0,3023.1244010930304,0.376,0.489,0.0,0.017,0.064
187,1819,598,201,0,4,803,4,807,2075,2119.0,3448.021354534266,0.394,0.396,0.0,0.014,0.154
188,1820,714,233,0,2,949,3,952,1835,2192.0,3071.984174327876,0.542,0.294,0.0,0.026,0.111
189,1821,402,170,0,2,574,5,579,1830,1989.0,3124.69384369309,0.029,0.933,0.0,0.002,0.026
190,1822,530,230,0,1,761,5,766,1552,1676.0,2569.0151183499565,0.576,0.265,0.0,0.015,0.11
191,1823,265,58,0,0,323,4,327,1018,866.0,1459.357961601625,0.386,0.433,0.0,0.078,0.069
192,1901,169,279,0,1,449,5,454,1309,1333.0,1658.102978393861,0.767,0.039,0.002,0.077,0.07
193,1902,478,330,0,2,810,13,823,1631,1645.0,2226.830792000898,0.776,0.075,0.0,0.107,0.013
194,1903,186,227,0,1,414,4,418,1091,1301.0,1614.9768836869473,0.767,0.063,0.005,0.069,0.061
195,1904,231,306,0,1,538,5,543,1580,1439.0,1923.739993313625,0.719,0.076,0.004,0.054,0.103
196,1905,262,270,0,1,533,9,542,1382,1091.0,1348.9070408752552,0.785,0.074,0.006,0.052,0.047
197,1906,289,363,0,2,654,7,661,1694,1626.0,1999.416000942343,0.767,0.078,0.008,0.059,0.056
198,1907,292,299,0,6,597,6,603,1658,2376.0,3863.700923909834,0.44,0.2,0.034,0.083,0.198
199,1908,199,179,0,0,378,3,381,847,704.0,893.2837555819272,0.864,0.057,0.0,0.018,0.003
200,1909,139,200,0,1,340,5,345,817,730.0,942.8419545622364,0.754,0.072,0.002,0.065,0.062
201,1910,373,257,0,3,633,3,636,1544,1755.0,2824.5329077329507,0.463,0.326,0.001,0.057,0.12
202,1911,209,79,0,2,290,4,294,1154,996.0,1655.083784980715,0.466,0.222,0.024,0.073,0.18
203,1912,284,185,0,1,470,8,478,979,807.0,1250.3591540645518,0.474,0.177,0.028,0.061,0.182
204,1913,226,151,0,2,379,1,380,1085,969.0,1759.7491805814452,0.402,0.356,0.0,0.053,0.162
205,2001,418,247,0,4,669,7,676,1644,1398.0,1896.6600459588767,0.886,0.031,0.0,0.021,0.014
206,2002,378,263,0,2,643,3,646,1577,1484.0,2205.2540585547586,0.745,0.124,0.0,0.048,0.036
207,2003,405,256,0,0,661,8,669,1623,2163.0,3485.7217059038585,0.451,0.367,0.0,0.069,0.079
208,2004,315,232,0,4,551,9,560,1210,1301.0,1768.5713205540774,0.885,0.031,0.0,0.022,0.015
209,2005,431,311,0,5,747,10,757,1585,2725.0,3524.381501578605,0.85,0.052,0.0,0.026,0.053
210,2006,504,328,0,2,834,7,841,1656,1819.0,2287.3182698692485,0.934,0.018,0.0,0.008,0.008
211,2007,289,190,0,1,480,6,486,996,1072.0,1461.743463377808,0.867,0.037,0.0,0.032,0.019
212,2008,243,221,0,2,466,5,471,1101,1173.0,1718.226366174252,0.766,0.127,0.0,0.023,0.011
213,2009,336,217,0,0,553,0,553,1247,1484.0,2215.719873022489,0.737,0.142,0.0,0.034,0.021
214,2010,479,380,0,1,860,4,864,1828,1778.0,2477.550546394052,0.781,0.045,0.0,0.058,0.084
215,2011,231,171,0,1,403,10,413,787,727.0,1021.0083212443716,0.804,0.025,0.0,0.067,0.072
216,2012,339,242,0,2,583,6,589,1022,1171.0,1600.4485865137735,0.842,0.051,0.0,0.047,0.018
217,2013,251,228,0,1,480,2,482,950,624.0,856.4157743015651,0.832,0.052,0.0,0.056,0.024
218,2014,332,215,0,5,552,4,556,964,1024.0,1436.9541494381526,0.804,0.025,0.0,0.067,0.072
219,2015,416,356,0,0,772,5,777,1714,1492.0,2126.290386051918,0.654,0.202,0.0,0.043,0.073
220,2016,525,344,0,4,873,5,878,1725,1512.0,1879.7365269431696,0.923,0.033,0.0,0.013,0.021
221,2017,546,371,0,6,923,6,929,1809,2762.0,3855.509484787059,0.786,0.055,0.0,0.099,0.051
222,2018,262,215,0,3,480,5,485,945,963.0,1316.7830783167751,0.842,0.051,0.0,0.047,0.018
223,2019,331,197,0,1,529,5,534,996,670.0,887.7099055835665,0.872,0.039,0.0,0.037,0.017
224,2020,387,254,0,2,643,29,672,1640,1070.0,1488.917350971697,0.795,0.054,0.0,0.091,0.046
225,2101,71,131,0,0,202,3,205,1915,2599.0,3156.9016228545875,0.735,0.039,0.001,0.169,0.044
226,2102,9,17,0,0,26,0,26,1207,3616.0,4234.956844634753,0.744,0.039,0.002,0.167,0.033
227,2103,54,71,0,2,127,1,128,1588,2482.0,3171.313871488174,0.663,0.068,0.0,0.217,0.039
228,2104,39,51,0,2,92,2,94,1191,1351.0,1945.8773528452336,0.637,0.063,0.001,0.162,0.106
229,2105,55,90,0,1,146,2,148,1421,2417.0,3247.9841803428326,0.678,0.056,0.0,0.185,0.067
230,2106,138,141,0,2,281,3,284,1167,1481.0,1967.3510315806911,0.698,0.043,0.001,0.19,0.043
231,2107,95,90,0,0,185,0,185,1425,1685.0,2315.7917453084424,0.704,0.058,0.001,0.161,0.051
232,2108,58,91,0,1,150,5,155,1664,1994.0,2749.1941100257827,0.748,0.04,0.0,0.166,0.026
233,2109,147,86,0,0,233,0,233,1746,3010.0,4089.663288695879,0.719,0.069,0.003,0.152,0.023
234,2110,207,82,0,0,289,1,290,1278,1381.0,1707.3061201079588,0.807,0.028,0.01,0.115,0.015
235,2111,144,142,0,0,286,0,286,1691,1937.0,2513.995116917914,0.795,0.026,0.0,0.148,0.021
236,2112,291,118,0,2,411,1,412,1697,1832.0,2213.1598233864283,0.828,0.018,0.013,0.106,0.012
237,2113,575,154,0,1,730,4,734,2103,2526.0,3117.356380849862,0.801,0.023,0.002,0.138,0.021
238,2114,48,74,0,0,122,0,122,916,927.0,1111.8363905392484,0.823,0.017,0.011,0.112,0.015
239,2115,79,96,0,0,175,3,178,1278,855.0,924.2333757417948,0.8,0.014,0.005,0.124,0.029
240,2116,224,180,0,1,405,4,409,1682,4119.0,4616.252318966596,0.782,0.012,0.0,0.159,0.037
241,2201,222,222,0,1,445,6,451,2139,5714.0,7387.390662674835,0.708,0.051,0.0,0.151,0.066
242,2202,198,207,0,4,409,2,411,2001,2094.0,3006.746445162941,0.661,0.056,0.001,0.159,0.096
243,2203,209,228,1,1,439,3,442,1674,2089.0,2834.765123817413,0.687,0.037,0.0,0.195,0.07
244,2204,184,198,0,0,382,2,384,1156,1109.0,1527.1759881118526,0.764,0.052,0.0,0.177,0.007
245,2205,126,97,0,0,223,3,226,953,1004.0,1401.6119998328131,0.751,0.03,0.0,0.154,0.047
246,2206,102,123,0,1,226,1,227,984,882.0,1138.1496392683034,0.709,0.01,0.0,0.228,0.036
247,2207,191,158,0,2,351,4,355,1477,1493.0,1840.0904284117987,0.786,0.037,0.002,0.131,0.035
248,2208,179,193,0,4,376,1,377,1394,2253.0,3051.7443854832486,0.805,0.041,0.0,0.145,0.005
249,2209,147,155,0,0,302,2,304,1392,1190.0,1524.9753262744878,0.875,0.019,0.0,0.098,0.001
250,2210,244,220,0,3,467,3,470,1664,1655.0,2258.58863723569,0.702,0.057,0.001,0.163,0.072
251,2211,168,142,0,1,311,5,316,1079,1730.0,2101.0222941101883,0.793,0.033,0.003,0.123,0.041
252,2212,192,171,0,2,365,7,372,1100,1604.0,2351.3839219401843,0.617,0.067,0.0,0.184,0.125
253,2213,144,134,0,1,279,0,279,911,958.0,1200.2651216628572,0.841,0.023,0.0,0.133,0.003
